########################################################################################
#@00000000000000000000000000000#-------------------------------------------------------#
#000000000000000000000000000000#-------------------------------------------------------#
#000000000000000000000000000000#-------------------------------------------------------#
#################=========######----------------------------------__________-----------#
----------------#,,,,,,,,,#-----------------------------------------________-----------#
#################,,,,,,,,,#-----------------------------------------_____--------------#
#,,,,,,,,,,,,,,,,,,,,,,,,,#######################--------------------------------------#
#,,,,,,,,,,,,,,,,,,,,,,,,,,,,,,,,,,,,,,,,,,,,,,,#--------------------------------------#
#,,,,,,,,,,,,,,,,,,,,,,,,,,,,,,,,,,,,,,,,,,,,,,,#-----------------_--------------------#
#00000000000000000000000000000000000000000000000#---------------____-------------------#
#00000000000000000000000000000000000000000000000#---------------__---------------------#
#00000000000000000000000000000000000000000000000#-------------_____--------------------#
#00000000000000000000000000000000000000000000000,----------------_---------------------#
#00000000000000000000000000000000000000000000000,--------------------------------------#
#00000000000000000000000000000000000000000000000,--------------------------------------#
#00000000000000000000000000000000000000000000000#--------------------------------------#
#00000000000000000000000000000000000000000000000#--------------------------------------#
#00000000000000000000000000000000000000000000000#--------------------------------------#
#00000000000000000000000000000000000000000000000#--------------------------------------#
#00000000000000000000000000000000000000000000000,--------------------------------------#
#00000000000000000000000000000000000000000000000,--------------------------------------#
#00000000000000000000000000000000000000000000000,--------------------------------------#
#################################################--------------------------------------#
------------------------------------------------#--------------------------------------#
------------------------------------------------#--------------------------------------#
------------------------------------------------#--------------------------------------#
------------------------------------------------#--------------------------------------#
------------------------------------------------#--------------------------------------#
------------------------------------------------#--------------------------------------#
------------------------------------------------#--------------------------------------#
------------------------------------------------#--------------------------------------#
------------------------------------------------########################################
