###################################################################################
#@000000000000000000000000000,-----~----------------------------------------------#
#0000000000000000000000000000,----------------------------!-----------------------#
###############=========#####,-----~----------------------!-----__________--------#
--------------#,,,,,,,,,#---------------------------------!-------________--------#
###############,,,,,,,,,#---------------------------------!-------_____-----------#
#,,,,,,,,,,,,,,,,,,,,,,,#######################-----------!-----------------------#
#,,,,,,,,,,,,,,,,,,,,,,,#,,,,,,,,,,,,,,,,,,,,,#-----------------------------------#
#00000000000######000000#000000000000000000000,-----------------------------------#
#00000000000000000000000#000000000000000000000,000000000###########################
#000000000000000000000000000000000000000000000,00000000000000000000000000000000000#
#000000000000000000000000000000000000000000000,00000000000000000000000000000000000#
###############################################00000000000000000000000000000000000#
----------------------------------------------#00000000000000000000000000000000000#
##############################################000000000000000000000000~00000000~00#
#000000000000000000000000000000000000000000000000000000000000000000000#############
#000000000000000000000000000000000000000000000000000000000000000000000000000000000#
#000000000000000000000000000000000000000000000000000000000000000000000000000000000#
#0000000000000000000000000000000000000000000000000000000000000000000~#000000000000#
###################################################################################
